,sex,sat_v,sat_m,sat_sum,hs_gpa,fy_gpa
0,1,46,46,92,2.69,1.83
1,2,42,57,99,2.98,1.63
2,1,44,48,92,2.66,2.75
3,1,52,59,111,2.63,3.3
4,1,50,45,95,2.6,1.59
5,1,37,56,93,3.21,2.41
6,1,38,59,97,3.25,1.04
7,1,40,62,102,3.62,2.35
8,1,47,62,109,3.53,3.33
9,2,41,58,99,3.58,1.06
10,2,50,60,110,3.34,2.48
11,2,43,54,97,3.84,2.24
12,2,53,55,108,4.02,3.34
13,1,51,37,88,2.58,2.38
14,1,39,56,95,2.36,3.11
15,2,27,56,83,3.2,2.26
16,1,60,56,116,2.8,3.14
17,2,23,53,76,3.48,1.04
18,1,35,54,89,3.18,1.82
19,1,45,54,99,3.9,1.25
20,1,41,53,94,4.0,3.19
21,2,41,45,86,2.39,3.23
22,1,50,57,107,2.49,1.73
23,2,49,48,97,2.73,3.57
24,1,43,58,101,2.95,2.09
25,2,41,57,98,3.17,1.59
26,2,51,64,115,2.96,2.14
27,1,52,58,110,2.61,3.44
28,2,41,71,112,3.34,2.4
29,1,67,55,122,2.15,2.47
30,2,34,58,92,3.97,2.23
31,2,44,59,103,3.28,2.67
32,2,34,56,90,3.31,1.73
33,2,33,52,85,2.52,1.38
34,2,20,19,39,1.3,-0.09
35,1,50,65,115,3.89,3.03
36,1,40,50,90,3.87,2.21
37,2,43,58,101,3.99,1.57
38,2,46,57,103,2.53,3.37
39,1,51,55,106,2.82,2.64
40,1,41,55,96,3.12,2.3
41,1,30,58,88,3.48,2.82
42,1,58,69,127,3.53,1.65
43,2,47,54,101,3.31,2.96
44,1,47,68,115,3.44,1.94
45,2,38,65,103,3.35,2.14
46,1,45,61,106,2.89,3.55
47,1,53,58,111,3.91,3.15
48,2,44,57,101,4.02,1.95
49,2,51,61,112,3.3,3.96
50,2,54,56,110,3.96,2.37
51,1,45,64,109,3.71,2.63
52,1,48,48,96,4.05,3.51
53,1,43,60,103,3.55,3.0
54,1,47,51,98,3.1,2.86
55,1,37,61,98,3.89,1.37
56,1,46,53,99,3.19,1.05
57,1,52,61,113,3.12,3.42
58,1,43,69,112,3.28,3.11
59,2,52,58,110,2.86,2.7
60,1,42,55,97,3.16,2.08
61,2,46,60,106,3.25,3.13
62,2,52,61,113,3.91,2.8
63,2,38,35,73,2.75,1.77
64,2,51,54,105,2.98,2.1
65,1,67,57,124,2.54,1.84
66,2,56,47,103,3.18,3.4
67,2,44,44,88,3.43,1.59
68,2,39,40,79,2.54,2.54
69,2,49,66,115,4.21,3.14
70,1,35,65,100,3.37,2.1
71,2,47,50,97,3.74,1.23
72,1,52,65,117,3.22,2.46
73,2,51,59,110,2.26,2.3
74,1,20,19,39,1.31,-0.1
75,1,38,72,110,3.01,2.58
76,2,48,45,93,2.76,0.81
77,2,46,55,101,3.85,2.43
78,1,45,63,108,3.82,3.17
79,1,39,54,93,3.34,1.94
80,1,47,51,98,3.65,2.65
81,2,20,19,39,1.28,-0.13
82,2,48,54,102,2.79,2.02
83,2,59,56,115,3.86,3.27
84,1,41,57,98,3.84,2.59
85,2,52,46,98,3.12,2.35
86,1,41,69,110,3.28,2.67
87,2,44,42,86,3.05,1.66
88,1,59,70,129,3.39,1.66
89,2,51,51,102,2.91,2.86
90,2,46,25,71,2.2,3.66
91,1,56,56,112,2.53,1.44
92,1,21,28,49,1.38,-0.06
93,1,39,61,100,3.98,2.03
94,1,61,74,135,2.87,2.13
95,2,53,65,118,3.14,2.69
96,2,20,19,39,1.31,-0.12
97,2,50,47,97,3.92,3.55
98,2,47,63,110,3.24,2.9
99,2,39,59,98,3.9,2.32
100,1,50,56,106,2.7,1.4
101,2,51,58,109,3.23,2.58
102,1,57,49,106,3.87,2.65
103,2,39,54,93,2.86,1.26
104,2,50,53,103,3.46,1.47
105,2,47,45,92,3.47,2.17
106,1,41,56,97,3.78,1.84
107,1,32,62,94,2.53,2.8
108,2,30,43,73,2.63,0.67
109,1,36,54,90,3.54,2.26
110,2,33,57,90,3.09,2.42
111,1,43,59,102,2.94,2.03
112,2,43,58,101,3.99,2.91
113,2,62,78,140,3.76,2.81
114,2,25,19,44,2.14,0.46
115,2,42,53,95,3.2,3.04
116,1,50,62,112,2.92,1.47
117,1,67,33,100,3.17,3.91
118,2,48,51,99,3.95,2.0
119,2,52,45,97,3.93,1.63
120,2,53,60,113,3.94,1.41
121,1,50,50,100,2.88,2.54
122,1,32,54,86,2.87,1.48
123,1,20,19,39,1.29,-0.12
124,1,40,53,93,2.96,1.28
125,1,35,56,91,2.82,2.85
126,1,50,54,104,2.78,2.01
127,2,44,52,96,4.08,3.27
128,1,47,56,103,2.88,1.78
129,2,51,57,108,3.1,2.26
130,1,47,59,106,3.51,2.67
131,2,41,58,99,2.58,2.25
132,1,53,60,113,3.5,1.78
133,2,43,71,114,3.58,1.92
134,1,42,50,92,2.4,2.08
135,2,47,55,102,3.8,2.44
136,1,48,60,108,2.83,3.39
137,1,53,62,115,3.34,3.11
138,1,40,41,81,3.05,2.53
139,2,27,62,89,3.29,2.01
140,1,54,56,110,2.95,3.03
141,2,47,38,85,3.79,2.36
142,2,37,63,100,4.04,3.14
143,1,42,69,111,3.1,1.43
144,1,51,54,105,3.28,1.66
145,2,35,68,103,3.54,2.07
146,2,53,45,98,3.68,2.78
147,1,42,61,103,3.76,3.03
148,1,44,62,106,2.84,3.18
149,2,32,54,86,3.42,2.18
150,2,58,54,112,3.38,2.93
151,2,46,43,89,3.73,2.54
152,2,38,61,99,3.23,1.5
153,1,54,57,111,2.48,3.01
154,2,60,73,133,4.12,3.55
155,1,48,56,104,2.72,3.01
156,2,21,21,42,1.41,0.96
157,1,60,69,129,3.94,1.93
158,1,34,63,97,4.0,1.7
159,2,46,64,110,3.35,2.95
160,2,42,37,79,3.96,1.56
161,1,45,57,102,3.25,1.94
162,2,51,60,111,3.39,3.15
163,2,43,53,96,3.54,2.53
164,2,37,48,85,3.23,2.63
165,1,53,61,114,3.42,3.32
166,1,47,63,110,2.86,1.84
167,2,58,52,110,3.2,2.89
168,2,44,57,101,3.53,2.23
169,2,20,21,41,1.91,0.33
170,1,45,73,118,4.09,2.39
171,1,45,56,101,2.69,1.01
172,2,49,64,113,3.52,2.55
173,2,38,61,99,3.84,2.93
174,1,57,37,94,2.47,2.48
175,1,56,56,112,3.44,3.27
176,1,42,63,105,4.0,2.47
177,2,63,67,130,3.94,3.26
178,2,55,55,110,3.17,3.35
179,1,40,58,98,3.26,2.18
180,2,23,19,42,1.42,1.27
181,2,40,42,82,3.3,2.0
182,2,43,58,101,3.58,2.71
183,2,48,68,116,2.53,2.92
184,1,27,58,85,2.47,2.57
185,1,33,73,106,2.54,1.65
186,1,50,48,98,3.77,1.9
187,2,46,62,108,2.84,2.24
188,2,44,64,108,3.99,3.73
189,2,36,54,90,2.73,2.77
190,2,50,66,116,3.18,2.87
191,1,52,48,100,3.8,1.29
192,1,56,71,127,4.0,2.8
193,2,57,53,110,3.83,3.06
194,1,43,57,100,3.78,1.93
195,1,47,45,92,2.41,2.37
196,1,36,54,90,3.97,2.24
197,1,49,62,111,2.96,2.1
198,2,38,51,89,4.01,3.02
199,2,53,60,113,3.43,2.06
200,2,46,64,110,3.9,2.52
201,1,54,41,95,2.99,1.86
202,2,42,62,104,4.21,2.98
203,1,53,62,115,4.07,3.16
204,2,48,56,104,3.01,2.58
205,2,49,53,102,3.22,1.74
206,2,52,61,113,3.96,3.36
207,2,40,55,95,2.31,2.85
208,1,47,60,107,3.31,3.01
209,1,48,60,108,3.58,2.74
210,1,63,73,136,3.72,2.18
211,2,47,55,102,3.08,2.56
212,2,56,61,117,4.01,3.47
213,1,47,65,112,3.95,2.0
214,2,20,19,39,1.28,-0.13
215,2,56,57,113,2.88,1.99
216,1,43,63,106,2.64,2.75
217,2,41,50,91,3.24,3.16
218,2,58,60,118,3.67,1.19
219,2,42,51,93,2.72,2.79
220,1,36,62,98,3.89,1.71
221,1,50,62,112,2.91,3.08
222,2,59,68,127,3.61,2.95
223,2,41,53,94,3.88,3.32
224,1,44,50,94,2.32,2.69
225,1,44,51,95,2.84,2.8
226,1,46,55,101,4.07,2.4
227,2,53,53,106,3.49,1.51
228,1,43,70,113,2.81,2.67
229,2,49,58,107,3.58,2.29
230,2,34,54,88,2.36,0.97
231,1,42,60,102,3.06,2.69
232,2,47,58,105,4.15,2.27
233,2,44,53,97,3.57,2.51
234,1,56,36,92,2.58,2.92
235,1,64,55,119,3.63,2.26
236,2,61,63,124,3.96,3.25
237,1,47,57,104,3.94,2.22
238,1,50,45,95,2.37,1.87
239,2,57,53,110,3.24,2.11
240,1,55,44,99,4.06,2.1
241,1,40,57,97,3.41,2.14
242,2,52,61,113,4.09,2.3
243,2,47,58,105,3.81,3.26
244,1,48,62,110,3.84,2.0
245,1,52,53,105,2.46,2.57
246,1,64,50,114,3.75,1.36
247,2,63,58,121,3.87,2.49
248,1,51,57,108,2.78,2.12
249,2,43,50,93,3.4,2.9
250,2,46,55,101,3.54,2.93
251,2,41,38,79,3.7,3.12
252,2,55,59,114,4.16,3.0
253,2,39,69,108,2.8,2.01
254,1,46,48,94,2.98,3.04
255,1,49,57,106,3.07,2.76
256,2,20,19,39,1.36,-0.09
257,1,45,58,103,3.08,1.96
258,2,50,63,113,3.23,2.32
259,1,30,50,80,3.79,0.8
260,1,50,63,113,2.93,1.68
261,1,57,63,120,3.51,3.0
262,2,45,42,87,3.28,2.14
263,1,41,63,104,3.55,2.71
264,1,40,57,97,2.96,2.7
265,2,45,52,97,4.03,3.3
266,2,46,58,104,2.79,2.41
267,1,55,55,110,4.05,2.97
268,2,40,62,102,3.77,1.73
269,1,43,61,104,3.09,2.98
270,1,52,62,114,2.2,3.03
271,1,57,62,119,2.36,3.18
272,1,43,58,101,2.87,2.14
273,2,52,59,111,3.75,3.02
274,1,48,54,102,3.72,2.29
275,2,57,56,113,3.46,3.52
276,1,46,65,111,2.54,2.01
277,1,36,50,86,3.18,2.03
278,2,26,63,89,3.26,2.85
279,2,51,53,104,3.52,2.61
280,2,47,57,104,2.77,1.83
281,2,51,67,118,4.07,3.02
282,1,25,25,50,1.72,1.47
283,1,59,55,114,3.75,0.82
284,1,45,58,103,3.91,3.02
285,2,41,70,111,3.84,3.04
286,2,47,52,99,2.71,3.37
287,2,36,56,92,2.85,2.08
288,1,55,56,111,3.7,2.66
289,2,48,71,119,4.18,3.19
290,1,52,62,114,3.39,2.91
291,2,64,55,119,3.09,3.14
292,1,46,49,95,3.71,1.89
293,2,53,57,110,2.94,3.04
294,1,44,62,106,3.23,3.43
295,2,42,57,99,3.74,3.08
296,1,46,46,92,3.2,3.03
297,2,47,69,116,4.01,1.15
298,1,43,44,87,2.99,3.02
299,2,39,46,85,3.72,2.63
300,1,40,62,102,2.89,2.79
301,1,47,57,104,3.38,3.23
302,2,52,52,104,3.33,2.95
303,2,53,39,92,3.1,3.13
304,1,29,59,88,2.89,0.42
305,1,50,72,122,4.05,2.39
306,2,50,62,112,3.91,2.43
307,2,61,50,111,3.74,2.11
308,1,50,61,111,2.76,1.35
309,2,20,19,39,1.28,-0.12
310,1,41,68,109,3.94,2.9
311,1,54,36,90,2.66,2.55
312,2,61,58,119,3.99,1.93
313,2,20,19,39,1.28,-0.14
314,2,27,40,67,2.78,1.77
315,1,47,47,94,3.82,2.21
316,2,31,46,77,2.52,0.72
317,1,43,55,98,2.73,2.79
318,1,52,61,113,3.8,3.8
319,1,51,59,110,3.63,2.51
320,2,41,50,91,3.5,1.97
321,1,53,53,106,2.69,1.93
322,2,34,49,83,3.2,1.54
323,1,36,55,91,3.74,1.39
324,2,42,57,99,3.34,2.31
325,1,61,71,132,3.45,2.53
326,2,44,54,98,3.16,2.53
327,1,65,65,130,3.25,3.08
328,2,51,40,91,3.91,2.15
329,1,56,59,115,3.07,1.06
330,1,44,62,106,3.46,2.89
331,2,37,69,106,4.09,2.4
332,1,51,49,100,2.78,2.41
333,2,45,40,85,3.01,1.27
334,2,41,39,80,3.66,1.76
335,1,48,57,105,3.81,3.23
336,2,54,61,115,3.77,1.6
337,1,36,50,86,2.52,2.9
338,1,39,64,103,2.58,1.59
339,2,47,48,95,3.2,2.06
340,1,50,62,112,3.48,1.73
341,2,48,61,109,3.93,3.17
342,2,47,54,101,3.55,1.38
343,2,48,36,84,2.73,2.0
344,2,50,62,112,3.66,3.33
345,1,55,56,111,3.38,1.74
346,2,63,41,104,2.79,1.28
347,2,33,32,65,3.25,3.5
348,2,61,41,102,4.07,2.97
349,2,46,56,102,3.58,1.62
350,1,47,53,100,2.64,1.96
351,2,42,44,86,3.03,2.98
352,1,47,60,107,2.81,2.97
353,2,58,56,114,3.49,2.15
354,1,48,52,100,3.71,3.32
355,1,45,50,95,3.68,1.2
356,2,20,19,39,1.29,0.15
357,2,44,47,91,3.87,2.61
358,2,41,50,91,2.04,1.25
359,1,55,50,105,3.06,1.72
360,2,67,51,118,3.08,3.12
361,2,27,24,51,1.85,1.39
362,2,54,62,116,4.01,2.58
363,1,43,54,97,3.09,1.49
364,2,56,47,103,3.88,2.19
365,1,28,57,85,3.05,1.32
366,2,57,57,114,3.8,1.27
367,2,47,49,96,3.14,1.93
368,1,60,60,120,3.82,2.23
369,2,54,58,112,4.06,3.28
370,1,50,52,102,3.84,3.0
371,1,48,63,111,3.37,2.64
372,2,51,56,107,4.0,2.96
373,2,61,55,116,4.0,1.58
374,1,46,54,100,3.34,3.18
375,1,51,63,114,3.77,3.02
376,2,61,52,113,3.09,1.83
377,2,46,52,98,3.82,2.06
378,1,60,60,120,2.77,2.45
379,1,46,50,96,3.13,1.98
380,1,43,51,94,2.08,2.55
381,1,39,59,98,2.61,1.59
382,2,35,66,101,2.3,2.38
383,1,52,50,102,3.83,1.43
384,2,20,19,39,1.39,-0.06
385,2,28,51,79,3.71,2.41
386,2,57,49,106,3.15,3.0
387,1,47,56,103,3.73,2.48
388,1,48,54,102,3.0,2.4
389,2,57,46,103,3.35,0.77
390,1,64,65,129,3.17,2.12
391,2,56,55,111,2.93,1.47
392,2,51,57,108,3.56,2.55
393,2,50,48,98,3.85,2.43
394,2,20,19,39,1.29,-0.1
395,1,41,58,99,3.42,3.14
396,2,55,55,110,2.93,1.84
397,2,47,70,117,4.05,2.85
398,1,63,61,124,2.87,1.76
399,2,45,40,85,3.47,1.25
400,1,44,62,106,2.81,2.72
401,1,55,59,114,2.92,3.5
402,1,42,56,98,1.99,2.57
403,1,45,58,103,2.51,2.62
404,1,56,64,120,3.16,1.48
405,1,45,58,103,3.85,1.73
406,1,38,48,86,3.21,2.34
407,1,42,59,101,3.36,2.32
408,1,57,59,116,3.85,2.33
409,2,36,64,100,2.94,1.82
410,2,37,55,92,2.84,1.97
411,1,53,55,108,3.47,2.6
412,2,45,50,95,2.36,2.88
413,1,55,63,118,3.91,2.42
414,1,71,56,127,3.97,2.47
415,2,58,55,113,3.6,2.75
416,2,48,61,109,2.93,2.2
417,2,69,54,123,3.78,3.37
418,1,54,64,118,3.52,2.02
419,1,44,54,98,3.93,2.81
420,2,53,51,104,2.62,2.1
421,1,34,68,102,3.78,2.09
422,1,53,60,113,2.84,2.64
423,1,51,41,92,3.12,1.06
424,1,46,47,93,3.31,2.8
425,1,46,53,99,4.09,2.37
426,1,53,53,106,3.37,1.13
427,1,30,57,87,3.0,2.12
428,2,41,68,109,3.12,2.95
429,2,46,48,94,2.32,2.07
430,2,49,56,105,3.15,1.41
431,1,38,59,97,3.32,1.87
432,2,68,68,136,3.87,1.96
433,2,46,44,90,2.67,1.31
434,2,60,54,114,3.74,2.06
435,2,54,54,108,2.34,1.75
436,2,30,63,93,3.55,3.18
437,2,60,51,111,3.97,3.44
438,1,43,58,101,4.01,2.66
439,2,39,52,91,2.45,1.62
440,2,48,45,93,3.97,2.3
441,2,60,59,119,3.7,3.92
442,1,43,63,106,3.82,2.45
443,1,55,58,113,2.37,2.04
444,1,49,59,108,2.77,1.82
445,1,54,58,112,2.63,0.53
446,1,53,54,107,2.89,2.68
447,2,56,59,115,4.13,2.44
448,2,40,60,100,3.96,1.76
449,2,45,36,81,3.3,3.79
450,2,41,44,85,4.02,1.66
451,1,47,50,97,3.3,3.27
452,1,60,56,116,4.09,2.4
453,1,51,45,96,2.45,2.46
454,2,47,50,97,3.21,2.58
455,2,50,48,98,3.8,2.82
456,1,58,64,122,3.35,1.59
457,2,45,56,101,3.88,2.15
458,1,31,53,84,2.69,2.73
459,2,52,54,106,3.03,2.7
460,1,56,54,110,3.67,1.77
461,1,43,57,100,2.77,1.49
462,1,66,65,131,2.7,2.61
463,1,54,58,112,2.93,1.71
464,1,57,49,106,3.7,1.98
465,1,20,20,40,1.32,-0.13
466,2,55,58,113,3.28,2.28
467,2,51,49,100,3.85,3.25
468,2,41,55,96,3.55,1.61
469,1,59,62,121,3.0,2.03
470,1,44,54,98,2.73,2.56
471,2,48,62,110,2.78,2.86
472,1,39,53,92,3.96,1.76
473,2,41,51,92,3.3,3.09
474,1,42,37,79,4.01,3.09
475,2,43,65,108,3.29,3.5
476,1,50,52,102,3.18,1.78
477,1,42,49,91,2.55,2.57
478,1,37,62,99,2.5,1.45
479,2,47,52,99,2.84,1.5
480,1,47,64,111,3.45,2.78
481,1,58,40,98,3.74,2.58
482,2,46,47,93,3.86,2.72
483,1,41,52,93,3.94,2.81
484,1,59,51,110,2.08,2.64
485,2,50,61,111,4.07,2.15
486,1,53,66,119,2.28,3.11
487,2,51,51,102,3.48,2.24
488,1,55,42,97,3.82,2.48
489,1,37,43,80,3.25,2.86
490,1,45,54,99,3.93,2.81
491,1,49,37,86,4.04,1.22
492,2,56,45,101,3.63,2.8
493,2,48,70,118,3.5,2.04
494,2,51,50,101,3.22,2.49
495,2,41,56,97,4.0,2.86
496,1,55,57,112,2.98,3.13
497,1,55,47,102,2.88,1.54
498,1,33,60,93,2.32,1.83
499,1,48,58,106,3.33,2.31
500,1,52,51,103,2.65,3.02
501,1,41,53,94,3.81,2.35
502,1,61,77,138,3.02,2.41
503,2,20,19,39,1.35,0.13
504,1,58,47,105,3.96,2.86
505,1,48,61,109,4.0,2.66
506,1,46,60,106,3.28,3.35
507,2,38,65,103,3.89,3.27
508,2,45,46,91,4.02,2.34
509,2,53,49,102,4.05,2.15
510,1,44,61,105,4.05,2.95
511,2,54,60,114,3.74,2.56
512,2,58,52,110,3.48,2.0
513,1,58,60,118,2.65,1.52
514,1,46,51,97,2.93,2.68
515,2,36,42,78,3.34,1.68
516,1,59,62,121,2.91,1.51
517,1,43,53,96,3.74,2.76
518,1,44,66,110,2.99,2.21
519,2,56,63,119,3.55,2.35
520,1,32,51,83,3.23,2.86
521,1,65,49,114,2.71,3.08
522,2,36,46,82,2.74,1.95
523,2,61,47,108,2.82,2.82
524,1,60,57,117,2.67,2.27
525,1,55,58,113,3.82,1.82
526,1,47,49,96,3.35,2.44
527,1,44,58,102,3.23,2.47
528,2,27,31,58,1.57,0.55
529,2,39,35,74,3.93,1.44
530,1,42,54,96,3.84,3.08
531,1,43,56,99,3.68,3.36
532,2,49,56,105,3.81,2.93
533,2,44,54,98,2.84,2.28
534,2,22,21,43,1.74,0.13
535,2,53,47,100,3.61,2.83
536,1,53,68,121,3.8,1.82
537,2,42,54,96,3.47,3.47
538,2,57,64,121,2.92,2.9
539,2,35,58,93,3.18,1.63
540,1,41,60,101,3.92,1.9
541,1,52,42,94,3.41,1.55
542,2,56,65,121,3.77,3.43
543,1,38,57,95,2.84,3.26
544,1,52,48,100,3.59,1.41
545,2,48,49,97,4.1,2.41
546,2,44,56,100,3.45,3.12
547,1,45,61,106,2.9,1.44
548,1,51,68,119,4.02,2.41
549,1,35,52,87,2.48,2.11
550,2,39,57,96,2.8,2.98
551,1,47,71,118,3.94,2.06
552,1,55,56,111,2.8,2.7
553,2,46,45,91,3.88,2.73
554,2,43,20,63,2.8,1.46
555,1,44,61,105,3.31,1.83
556,1,41,52,93,3.64,2.38
557,2,55,55,110,2.3,2.36
558,2,40,60,100,3.31,1.02
559,2,51,62,113,4.08,2.23
560,1,51,71,122,3.85,1.51
561,2,37,45,82,3.14,3.04
562,1,42,49,91,3.01,2.16
563,2,59,51,110,3.71,3.31
564,1,50,49,99,3.23,3.33
565,1,43,65,108,3.42,2.38
566,2,41,57,98,3.87,3.14
567,1,33,66,99,3.02,2.42
568,2,20,19,39,1.29,-0.01
569,2,35,59,94,3.32,2.66
570,2,59,57,116,3.36,2.7
571,2,51,44,95,3.28,1.14
572,2,46,52,98,2.92,2.46
573,1,51,54,105,2.54,1.19
574,1,52,49,101,2.73,1.88
575,2,34,60,94,4.07,3.37
576,1,54,55,109,3.75,3.34
577,2,49,50,99,2.94,2.68
578,1,56,66,122,3.74,1.87
579,2,44,51,95,2.96,1.77
580,2,33,53,86,4.04,2.93
581,1,47,58,105,2.6,2.91
582,1,46,59,105,2.76,3.54
583,1,51,48,99,2.32,3.75
584,1,39,55,94,2.9,2.7
585,1,44,53,97,2.83,1.98
586,2,41,47,88,3.62,1.65
587,1,54,37,91,2.53,1.54
588,1,66,60,126,3.94,2.84
589,2,54,54,108,4.13,1.98
590,2,41,54,95,2.84,3.02
591,1,53,49,102,2.61,2.75
592,1,53,62,115,3.95,1.94
593,2,20,19,39,1.29,-0.11
594,2,52,50,102,2.72,1.92
595,1,29,49,78,3.51,1.59
596,1,41,60,101,3.71,2.32
597,1,49,49,98,3.2,2.3
598,1,48,57,105,4.03,2.83
599,1,42,48,90,3.25,1.51
600,1,41,53,94,2.4,1.92
601,2,53,55,108,3.45,2.83
602,1,53,66,119,2.55,2.48
603,2,48,55,103,3.65,1.78
604,2,66,51,117,3.5,2.7
605,1,47,52,99,3.21,2.2
606,2,44,54,98,2.32,2.43
607,1,37,48,85,2.48,1.58
608,1,53,51,104,2.36,2.0
609,2,48,51,99,2.91,2.4
610,1,63,57,120,2.32,3.27
611,2,51,49,100,3.79,2.59
612,1,35,66,101,2.69,2.0
613,1,41,41,82,3.02,2.47
614,2,41,59,100,3.17,1.29
615,2,51,61,112,3.9,2.65
616,2,63,31,94,3.51,3.9
617,1,34,59,93,2.74,1.58
618,2,44,55,99,4.01,2.58
619,2,48,68,116,4.04,2.27
620,1,54,59,113,3.67,3.68
621,1,52,55,107,2.97,0.8
622,1,55,57,112,3.83,2.87
623,2,52,48,100,3.96,2.24
624,2,57,72,129,4.01,3.35
625,1,52,54,106,2.57,1.54
626,2,52,62,114,4.22,2.93
627,1,45,50,95,2.81,3.07
628,1,61,55,116,3.79,2.66
629,1,53,55,108,2.49,2.09
630,1,45,55,100,3.53,2.99
631,1,25,19,44,1.3,-0.07
632,1,37,62,99,3.1,2.57
633,2,42,50,92,3.15,2.5
634,1,41,62,103,2.92,2.44
635,1,45,50,95,2.55,2.91
636,2,42,54,96,3.42,2.64
637,2,61,39,100,4.09,0.45
638,2,47,58,105,3.54,2.8
639,1,47,39,86,3.18,2.23
640,1,45,53,98,3.53,3.0
641,1,21,21,42,1.42,-0.05
642,2,29,56,85,3.76,1.82
643,2,20,19,39,1.29,0.11
644,1,63,60,123,3.96,2.24
645,1,37,59,96,2.07,1.31
646,1,51,55,106,3.65,2.07
647,2,45,69,114,3.83,2.61
648,1,44,45,89,3.74,3.0
649,1,59,57,116,3.43,2.45
650,2,47,51,98,2.99,1.63
651,2,45,54,99,2.89,2.15
652,1,55,60,115,4.02,2.17
653,1,50,60,110,3.44,0.69
654,1,49,61,110,3.4,1.59
655,2,49,60,109,3.9,1.94
656,1,44,56,100,3.3,3.03
657,1,42,60,102,4.05,1.76
658,2,38,63,101,3.5,3.04
659,2,44,57,101,3.49,0.68
660,2,50,56,106,3.31,1.53
661,2,43,53,96,3.82,2.11
662,2,54,64,118,3.52,1.53
663,1,47,56,103,2.2,2.19
664,2,46,20,66,2.82,1.86
665,2,37,27,64,3.85,2.42
666,1,52,48,100,2.86,0.98
667,1,67,61,128,3.96,0.42
668,2,55,69,124,3.57,1.96
669,1,27,33,60,2.36,2.6
670,2,39,52,91,3.12,2.21
671,1,39,62,101,3.54,3.21
672,1,40,59,99,3.15,2.18
673,2,52,53,105,3.87,1.43
674,2,50,48,98,2.56,1.84
675,1,60,76,136,3.25,3.06
676,2,58,55,113,3.56,1.97
677,1,52,65,117,3.88,2.84
678,1,59,71,130,3.79,1.75
679,1,42,53,95,3.34,3.39
680,1,40,47,87,3.75,2.02
681,2,28,50,78,3.18,1.9
682,2,51,46,97,3.81,1.66
683,2,51,58,109,3.25,2.05
684,2,69,63,132,4.07,1.96
685,1,53,45,98,3.15,2.13
686,2,35,60,95,3.05,2.58
687,2,46,59,105,2.16,3.07
688,1,49,58,107,3.13,3.05
689,2,59,40,99,3.28,2.02
690,1,46,51,97,2.43,0.99
691,1,55,57,112,2.53,2.49
692,2,44,56,100,3.99,2.33
693,1,54,40,94,2.46,1.83
694,1,53,61,114,3.94,3.58
695,2,54,49,103,3.36,1.1
696,1,32,52,84,3.19,1.44
697,2,50,48,98,2.84,1.87
698,1,45,64,109,3.47,2.46
699,2,46,60,106,3.09,1.68
700,2,47,56,103,4.11,2.25
701,1,46,56,102,3.16,1.74
702,2,60,56,116,2.41,1.72
703,1,40,59,99,3.51,2.06
704,2,60,55,115,3.98,1.89
705,1,46,65,111,4.12,2.77
706,2,55,61,116,3.29,3.12
707,2,45,56,101,3.0,1.4
708,2,38,46,84,3.54,2.63
709,1,47,53,100,3.64,2.29
710,2,45,53,98,2.45,2.24
711,2,45,53,98,3.05,2.86
712,1,50,64,114,3.05,2.73
713,1,44,58,102,2.45,1.59
714,2,42,76,118,4.08,1.99
715,2,58,50,108,3.43,2.12
716,1,44,50,94,3.84,2.36
717,1,49,45,94,3.06,2.07
718,1,43,65,108,3.83,1.43
719,2,48,53,101,3.25,1.61
720,1,54,61,115,3.51,2.52
721,2,72,45,117,4.02,1.37
722,1,53,54,107,3.16,2.62
723,2,49,53,102,3.18,2.53
724,2,40,59,99,3.84,2.21
725,1,49,58,107,3.46,2.63
726,2,40,54,94,3.77,2.15
727,2,20,19,39,1.29,0.13
728,1,53,58,111,3.84,2.26
729,2,48,55,103,3.65,2.7
730,2,36,61,97,3.88,1.81
731,1,43,65,108,2.69,2.65
732,1,52,55,107,3.87,2.17
733,2,56,49,105,2.9,2.28
734,2,44,51,95,3.88,2.07
735,2,44,50,94,2.93,2.52
736,1,40,68,108,3.52,2.14
737,2,53,68,121,3.16,2.79
738,2,47,67,114,3.71,2.47
739,2,33,64,97,3.65,2.16
740,2,48,52,100,3.31,1.02
741,2,45,63,108,3.68,2.09
742,1,43,58,101,2.44,2.63
743,1,45,68,113,3.48,2.12
744,1,20,19,39,1.28,-0.13
745,2,46,44,90,3.01,2.86
746,2,43,50,93,4.12,1.91
747,1,50,57,107,3.85,2.38
748,1,54,65,119,2.72,2.14
749,2,42,58,100,3.45,3.05
750,2,46,55,101,3.03,2.01
751,1,53,55,108,3.83,2.2
752,2,39,59,98,3.72,2.96
753,1,55,72,127,3.96,3.1
754,1,59,61,120,3.92,2.86
755,1,42,51,93,2.96,2.54
756,2,50,52,102,3.85,1.46
757,2,47,62,109,3.84,2.77
758,2,60,63,123,3.38,3.38
759,1,45,59,104,3.94,3.0
760,1,62,52,114,3.38,3.03
761,1,47,56,103,3.17,3.54
762,2,36,69,105,3.83,3.48
763,1,51,56,107,3.75,1.9
764,1,74,54,128,2.4,1.92
765,1,46,68,114,3.58,3.29
766,2,40,52,92,4.07,3.33
767,1,50,65,115,3.34,2.18
768,1,35,61,96,3.87,3.05
769,2,39,66,105,3.27,3.12
770,2,53,58,111,3.85,0.68
771,2,44,55,99,3.99,2.25
772,1,42,52,94,2.12,2.26
773,1,58,60,118,3.77,2.02
774,2,47,53,100,3.24,2.8
775,1,58,53,111,3.23,1.59
776,2,52,51,103,3.78,2.39
777,1,64,55,119,3.85,1.55
778,1,45,57,102,2.11,2.84
779,2,55,55,110,2.7,2.04
780,1,42,62,104,3.04,3.25
781,2,66,31,97,3.55,3.88
782,1,45,51,96,3.73,2.03
783,1,39,64,103,3.08,3.08
784,2,45,58,103,2.91,2.9
785,2,64,45,109,2.5,2.1
786,2,41,55,96,3.72,3.48
787,1,55,42,97,3.69,2.71
788,1,61,55,116,3.0,2.86
789,2,72,52,124,4.01,2.57
790,1,38,43,81,3.79,1.0
791,2,28,36,64,1.81,1.66
792,1,38,55,93,3.73,2.05
793,1,48,72,120,2.78,2.9
794,1,49,47,96,2.8,2.13
795,2,40,58,98,3.77,1.48
796,2,50,57,107,2.4,2.25
797,1,51,47,98,3.05,1.41
798,2,45,57,102,3.51,3.04
799,2,54,46,100,3.06,1.78
800,1,57,66,123,2.83,3.56
801,2,50,51,101,4.04,3.01
802,2,52,50,102,2.62,3.54
803,1,49,66,115,2.41,1.87
804,1,42,53,95,3.16,2.98
805,2,42,55,97,2.99,2.79
806,2,51,68,119,4.08,3.27
807,2,52,56,108,2.99,2.41
808,2,33,65,98,3.18,3.58
809,2,59,56,115,3.02,2.44
810,2,59,51,110,3.42,3.52
811,1,35,53,88,3.41,2.7
812,1,55,54,109,3.59,2.18
813,2,65,68,133,3.55,3.47
814,2,38,60,98,3.76,1.92
815,1,39,61,100,3.83,2.43
816,2,28,58,86,3.92,3.08
817,2,51,63,114,4.04,2.74
818,2,45,56,101,3.92,3.65
819,2,53,45,98,2.88,2.18
820,1,47,58,105,3.47,2.81
821,2,27,38,65,2.8,0.51
822,2,58,53,111,3.97,2.56
823,1,46,66,112,3.87,2.18
824,2,42,43,85,3.42,1.56
825,1,53,56,109,3.35,3.03
826,2,64,43,107,2.72,2.55
827,1,45,55,100,2.76,2.93
828,2,57,64,121,3.85,2.42
829,1,58,48,106,2.9,1.92
830,1,57,59,116,3.7,2.54
831,1,63,68,131,3.49,0.98
832,2,55,68,123,3.64,3.11
833,2,47,42,89,3.32,0.77
834,2,57,46,103,3.49,3.38
835,1,38,65,103,2.79,2.72
836,1,63,52,115,2.65,3.12
837,2,40,53,93,4.02,2.92
838,2,61,58,119,3.76,2.04
839,1,51,53,104,2.94,3.43
840,2,48,62,110,3.54,2.92
841,1,40,51,91,3.08,2.61
842,1,35,59,94,2.76,2.53
843,2,56,51,107,2.74,3.12
844,1,42,49,91,3.51,2.81
845,1,44,62,106,2.65,2.35
846,2,43,62,105,4.0,2.89
847,1,46,68,114,3.31,2.23
848,1,56,57,113,2.84,1.98
849,2,44,49,93,3.84,2.89
850,2,39,38,77,2.94,2.17
851,2,41,60,101,3.86,2.46
852,2,20,19,39,1.28,-0.11
853,2,56,65,121,4.06,3.33
854,2,36,40,76,1.98,2.74
855,1,42,60,102,2.97,2.0
856,1,39,59,98,3.45,2.4
857,1,33,62,95,3.22,1.92
858,2,43,57,100,2.87,1.72
859,1,57,59,116,2.56,2.06
860,1,46,52,98,3.66,1.68
861,1,54,68,122,3.84,2.99
862,1,56,55,111,3.43,1.47
863,1,35,59,94,3.27,2.41
864,1,52,59,111,3.24,2.61
865,2,50,50,100,2.53,3.14
866,2,49,65,114,4.13,3.49
867,1,38,52,90,3.58,2.07
868,1,22,23,45,1.36,0.08
869,2,25,19,44,2.0,0.69
870,2,48,58,106,3.36,2.14
871,2,59,53,112,3.31,2.33
872,2,46,39,85,3.82,3.19
873,1,39,54,93,2.25,0.88
874,1,20,19,39,1.29,-0.12
875,2,56,50,106,2.9,2.62
876,2,48,47,95,3.7,2.81
877,2,40,55,95,3.92,1.77
878,2,47,62,109,2.45,3.02
879,2,61,63,124,3.57,3.6
880,2,28,64,92,3.36,2.11
881,1,64,52,116,2.71,2.26
882,2,45,45,90,2.95,1.86
883,2,39,65,104,3.7,2.96
884,2,41,66,107,3.47,2.76
885,1,44,65,109,4.05,2.12
886,1,46,67,113,3.81,1.17
887,2,57,60,117,3.46,3.21
888,2,56,54,110,3.98,2.75
889,2,40,35,75,2.0,1.58
890,1,52,49,101,2.74,2.02
891,2,46,45,91,3.17,2.6
892,1,37,55,92,3.26,1.66
893,2,43,50,93,3.93,1.96
894,2,20,22,42,1.56,-0.13
895,2,50,58,108,3.97,2.93
896,1,52,54,106,3.06,2.12
897,2,50,52,102,3.83,2.4
898,1,45,66,111,2.83,2.89
899,2,45,61,106,3.16,2.29
900,1,39,51,90,3.71,2.39
901,2,58,63,121,3.81,2.56
902,1,46,58,104,2.64,2.05
903,2,32,53,85,2.49,2.01
904,1,43,54,97,3.51,2.69
905,2,44,61,105,3.6,2.29
906,1,34,49,83,2.84,1.91
907,2,57,51,108,3.31,2.08
908,1,50,63,113,3.93,3.05
909,1,32,68,100,3.28,2.17
910,2,48,58,106,3.78,2.41
911,1,50,64,114,4.13,2.22
912,2,49,57,106,3.78,2.33
913,2,43,52,95,3.06,2.66
914,1,63,56,119,3.63,2.58
915,2,52,54,106,3.9,1.72
916,2,45,68,113,3.89,2.75
917,1,50,69,119,3.81,2.74
918,2,23,43,66,1.45,1.47
919,2,50,44,94,3.07,2.66
920,2,53,62,115,3.95,2.03
921,2,64,45,109,3.37,2.4
922,1,41,56,97,2.27,0.95
923,2,59,56,115,4.31,3.37
924,1,45,74,119,3.32,2.17
925,2,43,49,92,3.93,1.6
926,1,49,59,108,2.88,1.02
927,2,61,45,106,3.67,3.55
928,1,54,67,121,3.41,1.82
929,1,58,54,112,3.3,2.37
930,1,61,58,119,3.44,1.93
931,1,56,55,111,2.75,1.65
932,1,55,71,126,3.73,2.9
933,2,51,59,110,3.32,1.56
934,2,47,44,91,2.25,3.1
935,1,51,51,102,2.1,2.29
936,1,36,61,97,2.74,2.28
937,2,38,44,82,3.86,1.21
938,1,57,45,102,3.91,2.03
939,2,21,29,50,1.45,0.69
940,1,51,51,102,3.07,2.84
941,1,67,54,121,3.44,2.49
942,1,55,52,107,3.57,0.82
943,2,59,56,115,3.15,3.11
944,1,44,46,90,2.54,2.6
945,2,44,49,93,3.45,0.17
946,2,51,53,104,2.31,2.69
947,1,57,46,103,2.75,0.69
948,2,64,48,112,3.89,2.75
949,1,36,49,85,2.76,1.53
950,1,54,50,104,2.9,2.45
951,1,62,57,119,3.85,2.07
952,1,51,67,118,4.02,2.4
953,1,43,56,99,3.33,2.89
954,2,24,19,43,1.44,0.64
955,2,52,54,106,3.26,2.39
956,2,38,52,90,2.7,0.98
957,1,52,50,102,2.98,2.08
958,1,64,56,120,3.61,3.47
959,1,47,44,91,2.4,1.1
960,2,21,20,41,1.82,0.14
961,2,46,49,95,3.14,2.1
962,2,58,60,118,2.67,2.8
963,1,41,51,92,3.05,1.65
964,2,55,61,116,3.04,2.38
965,1,42,60,102,3.59,3.37
966,1,41,47,88,2.78,1.55
967,2,28,44,72,3.82,2.1
968,2,44,62,106,3.23,3.13
969,2,20,19,39,1.28,-0.14
970,2,48,58,106,3.31,2.98
971,2,20,19,39,1.29,-0.05
972,1,40,58,98,2.78,3.09
973,2,50,55,105,3.34,2.26
974,1,44,42,86,2.8,2.62
975,2,51,54,105,3.08,2.48
976,2,48,60,108,3.65,2.98
977,2,56,60,116,4.0,1.55
978,2,57,48,105,2.97,3.38
979,2,59,60,119,2.57,2.16
980,2,48,63,111,3.44,2.3
981,2,23,28,51,1.43,0.02
982,1,32,62,94,3.26,2.84
983,2,34,62,96,3.32,1.79
984,2,35,20,55,2.41,1.28
985,2,37,62,99,3.79,1.84
986,1,39,61,100,2.67,1.83
987,2,55,53,108,3.48,2.86
988,1,38,61,99,3.56,2.33
989,2,58,50,108,3.09,1.54
990,1,60,57,117,3.28,1.93
991,2,60,51,111,2.63,3.49
992,2,45,57,102,3.97,2.07
993,1,58,74,132,3.07,2.49
994,1,26,19,45,2.09,2.63
995,1,40,65,105,3.99,3.42
996,2,68,67,135,3.95,3.43
997,1,40,44,84,3.28,1.6
998,2,48,68,116,3.75,2.26
999,1,45,64,109,2.98,2.83
