"","sex","sat_v","sat_m","hs_gpa","fy_gpa","sat_sum"
"1","female",46,57,3.8,3.02,103
"2","male",47,51,3.69,2.84,98
"3","female",39,46,2.9,0.95,85
"4","male",54,48,3.36,2.33,102
"5","female",37,45,3.13,3.92,82
"6","female",40,50,2.24,1.06,90
"7","male",39,61,2.76,2.34,100
"8","male",64,72,3.24,2.42,136
"9","male",64,53,3.07,3.07,117
"10","female",47,58,3.6,2.83,105
"11","female",47,62,2.05,1.33,109
"12","female",61,60,2.38,1.27,121
"13","female",45,44,3.79,2.02,89
"14","male",52,53,2.73,2.68,105
"15","female",50,58,3.62,2.78,108
"16","male",42,39,2.09,1.98,81
"17","male",42,58,2.94,2.08,100
"18","female",55,63,3.99,4.18,118
"19","female",42,55,2.73,2.06,97
"20","male",62,61,3.01,2.18,123
"21","female",55,61,3.57,3.4,116
"22","female",55,50,3.44,2.59,105
"23","female",68,58,2.72,3.41,126
"24","female",57,62,3.27,2.73,119
"25","male",46,54,4.12,2.58,100
"26","male",57,69,4,3.17,126
"27","male",50,56,2.82,0.84,106
"28","male",55,58,3.37,1.15,113
"29","female",66,55,3.52,3.2,121
"30","female",39,55,2.34,1.66,94
"31","female",38,52,3.62,2.23,90
"32","female",51,59,3.66,2.06,110
"33","male",43,42,3.2,2.06,85
"34","female",46,42,3.32,1.58,88
"35","male",43,57,2.43,1.9,100
"36","female",41,46,3.03,2.64,87
"37","female",47,51,3.34,1.47,98
"38","female",56,51,3.24,2.27,107
"39","male",55,53,2.99,3.11,108
"40","female",57,65,2.95,2.09,122
"41","female",49,55,3.8,3.19,104
"42","female",55,56,2.99,2.64,111
"43","male",49,69,3.75,3.33,118
"44","male",34,42,2.12,1.67,76
"45","female",45,46,2.31,1.95,91
"46","male",51,59,4.11,2.92,110
"47","male",46,52,3.84,2.98,98
"48","male",49,56,3.5,3.02,105
"49","male",47,59,2.44,1.38,106
"50","female",47,58,3.86,1.64,105
"51","female",48,55,3.23,1.94,103
"52","male",46,56,3.02,2.9,102
"53","female",54,53,3.01,2.51,107
"54","female",44,34,3.16,1.51,78
"55","male",54,60,2.94,2.37,114
"56","male",43,45,2.38,1.35,88
"57","male",54,62,3.92,3.75,116
"58","female",46,50,2.34,2.93,96
"59","female",53,55,3.38,1.65,108
"60","female",51,54,3.09,2.03,105
"61","male",57,53,2.59,1.85,110
"62","male",47,59,4.07,2.12,106
"63","female",61,55,2.99,2.47,116
"64","male",61,63,3.57,2.61,124
"65","male",53,61,3.14,3.83,114
"66","female",43,50,4.03,1.47,93
"67","male",40,49,2.89,3.06,89
"68","male",51,55,2.75,2.72,106
"69","male",35,58,2.7,2.06,93
"70","male",40,51,2.06,0.7,91
"71","male",57,57,3.48,2.42,114
"72","male",60,69,4,4.07,129
"73","female",37,47,3.32,1.8,84
"74","female",48,60,3.56,3.26,108
"75","male",55,59,3.33,2.96,114
"76","male",34,54,2.64,2.28,88
"77","male",57,54,3.34,2.36,111
"78","male",46,69,4.02,2.94,115
"79","female",45,56,3.1,2.49,101
"80","male",43,56,3.45,2.84,99
"81","female",49,67,2.39,2.33,116
"82","male",43,58,2.86,2.26,101
"83","male",53,57,3.28,2.72,110
"84","male",38,45,3.15,2.9,83
"85","female",52,59,3.32,2.21,111
"86","female",34,60,3.17,2.81,94
"87","female",35,50,3.31,1.6,85
"88","female",49,56,2.66,2.07,105
"89","male",47,58,3.94,2.13,105
"90","female",33,44,3.13,2.35,77
"91","male",55,49,2.62,0.84,104
"92","male",38,41,3.67,2.8,79
"93","female",46,59,3.5,1.43,105
"94","female",55,64,3.45,2.3,119
"95","male",38,44,2.97,1.54,82
"96","male",51,63,3.27,2.87,114
"97","male",35,46,2.31,0.72,81
"98","male",44,49,2.43,0.94,93
"99","male",54,55,2.8,2.98,109
"100","female",54,60,3.3,3.68,114
"101","male",55,64,3,3.02,119
"102","female",53,53,3.27,1.57,106
"103","male",49,50,3.2,3.39,99
"104","male",46,51,4,2.66,97
"105","male",57,59,3.62,3.01,116
"106","male",43,59,3.18,2.78,102
"107","female",49,57,3.88,3.14,106
"108","female",58,67,3.96,3.33,125
"109","male",47,51,3.71,3.15,98
"110","female",45,48,2.59,2.07,93
"111","male",49,57,3.56,3.14,106
"112","female",47,57,3.19,1.12,104
"113","male",65,75,3.42,2.61,140
"114","male",46,50,3.41,2.92,96
"115","male",55,50,2.45,2.19,105
"116","male",47,59,2.97,1.88,106
"117","female",47,55,3.41,2.16,102
"118","female",54,55,3.93,2.54,109
"119","female",58,67,3.43,2.23,125
"120","female",48,53,4.07,3.57,101
"121","female",46,51,3.53,2.38,97
"122","male",45,59,3.89,3.55,104
"123","male",60,59,2.9,2.58,119
"124","male",55,51,3.77,2.18,106
"125","female",40,36,2.37,1.72,76
"126","female",70,65,2.43,2.24,135
"127","male",45,55,3.23,2.23,100
"128","female",45,55,3.35,2.54,100
"129","female",57,60,3.69,2.84,117
"130","female",46,46,3.72,2.93,92
"131","male",41,48,2.68,1.05,89
"132","male",43,54,2.93,2.38,97
"133","female",49,58,3.45,1.82,107
"134","female",54,47,3.76,2.93,101
"135","male",48,72,4.05,3.43,120
"136","male",40,45,3.12,1.67,85
"137","female",55,60,4.05,3.41,115
"138","male",45,59,2.69,1.38,104
"139","male",45,46,2.17,0.62,91
"140","male",49,70,4,3.14,119
"141","female",48,43,3.38,1.66,91
"142","male",42,62,3.5,2.66,104
"143","male",49,73,3.85,3.41,122
"144","female",56,67,4.08,2.84,123
"145","female",62,64,4.07,2.86,126
"146","female",44,59,3.09,3.67,103
"147","female",52,63,3.99,3.57,115
"148","male",50,53,2.52,1.76,103
"149","female",32,44,2.49,1.21,76
"150","female",57,64,3.62,3.3,121
"151","female",46,47,2.81,2.09,93
"152","female",48,38,3.18,2.24,86
"153","male",51,52,2.98,1.99,103
"154","female",64,54,3.65,3.04,118
"155","male",57,58,2.94,2.06,115
"156","male",51,56,3.54,2.36,107
"157","male",35,60,2.86,2.47,95
"158","female",47,63,3.37,2.58,110
"159","female",38,45,3.32,1.94,83
"160","female",50,51,3.43,3.21,101
"161","male",43,51,2.5,1.8,94
"162","male",56,58,3.79,3.18,114
"163","male",51,67,3.76,3.29,118
"164","male",31,34,2.14,0.22,65
"165","female",50,54,3.64,2.88,104
"166","male",39,46,3.88,2.52,85
"167","female",48,51,3.14,1.56,99
"168","female",52,63,3.37,2.39,115
"169","male",42,45,3.27,2.66,87
"170","male",52,58,2.88,1.47,110
"171","male",51,58,3.27,2.44,109
"172","male",47,66,3.44,1.2,113
"173","male",43,54,3.66,2.59,97
"174","female",31,49,2.11,1.45,80
"175","female",47,65,3.93,2.43,112
"176","female",58,65,3.84,2.45,123
"177","male",46,53,3.44,2.55,99
"178","male",47,52,2.9,2.53,99
"179","female",43,41,3.1,3.26,84
"180","female",48,54,2.88,3.82,102
"181","female",60,58,3.42,3.4,118
"182","female",36,47,2.64,2.15,83
"183","female",48,59,2.84,3.38,107
"184","female",57,53,3.76,3.11,110
"185","female",53,58,3.23,2.38,111
"186","female",47,67,3,2.23,114
"187","male",37,47,3.37,1.46,84
"188","male",53,47,3.71,1.93,100
"189","female",45,59,2.14,2.22,104
"190","male",45,48,4.04,3.23,93
"191","female",47,52,3.34,2.3,99
"192","female",57,65,3.1,1.66,122
"193","male",55,64,2.54,1.8,119
"194","male",56,59,3.42,3.2,115
"195","male",55,59,4,3.41,114
"196","male",42,37,2.23,1.32,79
"197","male",41,50,2.85,2.66,91
"198","female",58,71,3.47,2.74,129
"199","male",51,54,3.84,2.9,105
"200","female",61,60,3.65,3.11,121
"201","female",48,32,2.21,0.82,80
"202","female",37,45,2.79,1.92,82
"203","female",53,60,3.38,2.04,113
"204","female",45,45,2.72,2.96,90
"205","male",62,52,3.83,1.73,114
"206","male",53,64,3.06,2.55,117
"207","female",53,53,3.9,3.11,106
"208","male",52,66,2.66,3.17,118
"209","male",34,46,2.67,1.46,80
"210","male",52,54,2.99,2.66,106
"211","male",49,54,2.98,2.51,103
"212","male",47,50,3.13,2.6,97
"213","female",40,51,2.45,1.8,91
"214","female",53,46,3.15,3.85,99
"215","male",56,58,3.44,3.45,114
"216","male",40,49,2.24,1.25,89
"217","male",45,47,3.5,3.9,92
"218","male",42,59,3.84,3.42,101
"219","male",51,59,3.89,3.68,110
"220","female",56,51,3.81,4.02,107
"221","male",53,61,3.35,2.76,114
"222","male",44,43,2.94,2.75,87
"223","female",34,40,3.39,2.35,74
"224","female",34,58,3.15,2.12,92
"225","female",46,59,3.54,2.77,105
"226","male",53,56,3.12,1.98,109
"227","male",53,50,3.22,3.89,103
"228","male",56,65,3.43,2.33,121
"229","female",46,49,2.76,1.72,95
"230","male",51,67,3.29,3.35,118
"231","male",32,43,2.58,1.46,75
"232","male",52,66,2.44,2.34,118
"233","male",53,46,3.26,2.3,99
"234","female",50,48,3.94,3.47,98
"235","female",54,55,3.59,2.85,109
"236","male",55,50,4.12,3.51,105
"237","male",47,56,3.51,2.55,103
"238","male",48,46,3.28,2.19,94
"239","male",49,55,2.61,2.43,104
"240","female",53,67,3.46,2.48,120
"241","male",47,60,3.83,3.07,107
"242","female",56,60,3.47,2.26,116
"243","female",45,50,2.17,1.23,95
"244","male",53,59,4.11,2.79,112
"245","female",46,56,4.09,1.62,102
"246","female",31,55,2.06,1.66,86
"247","male",51,55,2.97,2.81,106
"248","male",58,66,3.56,3.31,124
"249","male",63,60,3.72,1.69,123
"250","female",40,60,2.76,2.21,100
"251","male",49,66,3.02,2.5,115
"252","female",54,61,3.35,2.61,115
"253","male",46,65,3.11,2.76,111
"254","male",41,65,2.85,2.58,106
"255","male",47,46,2.19,1.13,93
"256","male",47,48,2.94,3.53,95
"257","female",34,49,2.78,2.46,83
"258","female",45,55,2.44,2.37,100
"259","female",44,60,3.47,2.4,104
"260","male",60,63,3.89,3.32,123
"261","female",55,60,3.53,2.25,115
"262","male",50,64,3.18,2.65,114
"263","male",44,57,3.24,2.58,101
"264","female",36,50,2.71,1.74,86
"265","female",38,38,2.31,0.84,76
"266","male",46,46,2.28,1.17,92
"267","female",51,57,2.58,3.17,108
"268","male",63,72,3.9,2.72,135
"269","male",44,64,3.62,2.45,108
"270","female",56,55,3.23,1.62,111
"271","female",47,53,2.92,1.22,100
"272","female",45,51,2.66,1.61,96
"273","female",51,47,2.82,1.89,98
"274","male",53,65,4.03,3.1,118
"275","male",48,43,2.99,1.81,91
"276","female",51,60,3.45,2.59,111
"277","female",44,58,2.83,2.73,102
"278","male",51,58,3.03,2.02,109
"279","female",48,49,3.39,1.82,97
"280","female",48,55,3.54,2.09,103
"281","male",55,66,4.1,2.83,121
"282","female",44,50,3.41,1.42,94
"283","male",37,63,3.41,1.8,100
"284","male",41,49,4.07,2.94,90
"285","male",46,46,3.81,2.45,92
"286","female",45,55,2.62,3.12,100
"287","female",48,50,2.65,3.11,98
"288","male",35,39,2.16,2.83,74
"289","male",45,46,3.62,3.47,91
"290","male",49,49,3.25,2.49,98
"291","male",38,57,2.86,1.04,95
"292","male",50,54,2.53,0.89,104
"293","female",49,39,2.72,1.75,88
"294","female",55,66,2.73,2.82,121
"295","male",39,40,2.16,1.52,79
"296","female",48,55,2.89,2.75,103
"297","male",41,41,2.31,1.22,82
"298","female",54,60,4.12,2.97,114
"299","female",45,57,3.17,2.57,102
"300","male",45,50,2.44,1.37,95
"301","male",51,55,3.81,3.04,106
"302","female",49,60,3.06,3.69,109
"303","female",49,57,3.73,3.61,106
"304","female",59,61,3.66,2.96,120
"305","male",51,61,3.84,1.87,112
"306","male",54,50,2.89,2.08,104
"307","male",66,54,3.99,4.2,120
"308","male",54,47,2.89,2.59,101
"309","female",36,45,2.83,2.09,81
"310","male",30,50,2.18,1.48,80
"311","male",46,51,2.31,1.22,97
"312","female",46,44,3.04,2.13,90
"313","female",66,64,3.83,3.25,130
"314","male",44,61,3.58,3.22,105
"315","female",45,60,3.65,2.66,105
"316","female",46,52,2.54,2.23,98
"317","male",50,49,3.75,2.36,99
"318","male",55,52,4.12,3.31,107
"319","female",46,45,2.14,1.18,91
"320","male",40,55,2.52,2.04,95
"321","female",40,57,3.46,2.27,97
"322","female",29,48,3.47,1.98,77
"323","male",70,66,3.98,1.72,136
"324","female",61,60,2.08,1.26,121
"325","male",55,57,3.64,2.45,112
"326","male",43,58,2.59,1.89,101
"327","female",59,54,2.43,2.81,113
"328","male",41,49,3.28,2.11,90
"329","male",46,37,2.4,2.19,83
"330","male",45,45,3.7,2.98,90
"331","male",44,40,2.76,2.33,84
"332","male",61,62,3.86,2.63,123
"333","male",51,59,3.54,3.14,110
"334","male",34,49,2.3,2.04,83
"335","male",42,55,2.59,2.9,97
"336","female",55,60,3.94,3.71,115
"337","female",61,65,3.48,3.24,126
"338","female",45,50,3.82,2.85,95
"339","female",42,49,2.71,2.21,91
"340","female",49,53,3.44,2.64,102
"341","female",42,52,3.08,2.05,94
"342","male",45,57,2.26,1.67,102
"343","male",32,49,2.46,1.81,81
"344","male",49,48,3.29,2.86,97
"345","male",43,49,3.54,3.12,92
"346","male",56,63,4.02,3.76,119
"347","female",41,53,3.47,2.82,94
"348","female",53,61,3.37,2.73,114
"349","female",46,63,3.72,3.5,109
"350","male",46,62,3.08,2.69,108
"351","female",34,57,2.65,2.06,91
"352","female",59,58,4.04,4.2,117
"353","female",48,54,3.49,3.17,102
"354","male",47,62,3.02,2.01,109
"355","female",64,58,3.63,2.46,122
"356","female",57,57,2.59,1.55,114
"357","female",50,48,3.23,1.98,98
"358","male",43,50,3.73,2.83,93
"359","male",60,68,4.09,3.81,128
"360","male",35,40,2.12,0.71,75
"361","female",60,61,3.05,1.69,121
"362","male",49,47,3,1.9,96
"363","male",58,50,2.58,2.24,108
"364","female",43,53,2.49,1.67,96
"365","female",36,49,3.33,2.12,85
"366","female",49,55,3.07,3.03,104
"367","female",66,42,2.96,1.49,108
"368","male",56,66,3.32,2.94,122
"369","female",49,47,2.25,2.51,96
"370","male",53,60,3.44,2.46,113
"371","male",32,39,2.21,1.26,71
"372","male",51,63,4.12,3.53,114
"373","male",56,63,3.09,2.37,119
"374","male",44,37,2.89,2.84,81
"375","male",44,46,3.48,2.15,90
"376","female",57,58,3.46,2.5,115
"377","male",53,53,3.81,3.62,106
"378","male",54,42,3.07,2.88,96
"379","male",47,47,3.29,3.18,94
"380","male",55,73,3.63,3.62,128
"381","female",45,61,2.91,2.54,106
"382","male",43,61,3.41,1.72,104
"383","male",38,67,3.13,2.09,105
"384","male",64,57,3.61,2.91,121
"385","female",46,56,2.83,1.97,102
"386","female",35,37,2.82,2.62,72
"387","female",50,46,2.89,2.46,96
"388","female",54,64,3.7,3.13,118
"389","male",54,61,3.27,2.49,115
"390","female",43,47,3.26,2.81,90
"391","female",53,55,3.91,2.62,108
"392","female",55,67,4.11,3.75,122
"393","female",49,51,2.15,2.3,100
"394","male",61,62,3.05,2.87,123
"395","male",55,62,3.56,2.23,117
"396","male",33,45,3.26,1.38,78
"397","female",59,58,3.69,2.53,117
"398","female",53,47,2.3,1.96,100
"399","male",63,57,3.58,3.4,120
"400","male",53,51,3.65,2.74,104
"401","female",43,53,3.68,2.69,96
"402","male",50,62,3.71,3.6,112
"403","male",53,63,3.45,2.51,116
"404","male",46,55,3.4,2.59,101
"405","female",48,48,2.69,2.21,96
"406","female",66,68,3.68,3.04,134
"407","male",46,66,3.54,2.12,112
"408","male",42,63,2.68,1.31,105
"409","male",46,51,4.06,2.92,97
"410","female",46,52,3.04,2.63,98
"411","male",36,63,2.71,2.49,99
"412","female",46,59,2.9,2.19,105
"413","male",40,46,3,2.75,86
"414","female",60,52,3.15,2.2,112
"415","female",44,67,3.49,2.45,111
"416","female",61,75,4.12,3.72,136
"417","male",48,61,3.58,1.78,109
"418","female",46,51,3.01,2.32,97
"419","female",50,54,2.55,2.09,104
"420","male",53,62,3.13,2.85,115
"421","female",32,51,2.22,1.81,83
"422","female",49,59,3.24,1.4,108
"423","female",46,58,2.93,2.52,104
"424","male",42,50,2.29,1.76,92
"425","female",58,50,3.69,3.13,108
"426","male",54,66,2.85,2.47,120
"427","female",36,38,2.47,0.51,74
"428","female",49,61,2.95,2.26,110
"429","female",37,47,3.42,0.29,84
"430","male",59,60,3.82,3.52,119
"431","male",47,64,2.69,2.87,111
"432","male",51,34,2.89,3.44,85
"433","male",51,53,3.67,1.17,104
"434","male",56,62,3.44,3.15,118
"435","male",39,44,3.96,3.13,83
"436","male",65,55,3.54,3.14,120
"437","male",41,37,3.96,1.94,78
"438","female",43,52,2.44,1.75,95
"439","female",56,70,4.12,3.58,126
"440","male",35,49,2.76,2.01,84
"441","male",53,65,3.86,3.09,118
"442","male",57,51,2.83,1.51,108
"443","female",41,49,2.99,2.39,90
"444","female",48,62,3.03,2.61,110
"445","female",57,57,3.38,2.86,114
"446","female",48,43,3.24,3.04,91
"447","female",38,48,3.66,2.53,86
"448","male",34,44,3.01,2.98,78
"449","male",66,67,4,3.4,133
"450","male",59,64,4.02,3.24,123
"451","male",48,51,2.06,1.47,99
"452","female",51,43,2.23,2.23,94
"453","male",48,56,2.58,2.22,104
"454","female",48,56,2.47,1.71,104
"455","female",42,46,2.46,2.71,88
"456","female",68,71,4.12,3.49,139
"457","female",47,49,2.2,2.03,96
"458","male",54,64,2.59,2.98,118
"459","male",52,54,2.84,2.18,106
"460","male",45,65,3.17,2.64,110
"461","male",40,46,2.86,2.45,86
"462","female",50,62,2.87,2.88,112
"463","female",43,58,3.14,1.61,101
"464","male",51,62,2.99,2.83,113
"465","female",60,60,3.97,2.43,120
"466","male",39,47,2.21,2.59,86
"467","male",47,46,3,1.91,93
"468","male",45,42,2.29,1.18,87
"469","female",52,51,3.02,2.57,103
"470","male",39,45,3.29,1.56,84
"471","male",32,47,2.51,1.16,79
"472","male",44,53,3.71,3.04,97
"473","female",59,54,4.01,3.47,113
"474","male",47,57,2.8,3.36,104
"475","female",39,55,4.11,2.38,94
"476","male",44,45,3.62,2.9,89
"477","male",43,47,2.06,1.57,90
"478","male",48,56,3.77,2.53,104
"479","male",41,44,3.59,2.78,85
"480","female",54,51,2.73,3.42,105
"481","male",61,53,3.3,1.48,114
"482","female",48,57,3.13,1.77,105
"483","female",43,47,2.78,1.09,90
"484","male",46,65,2.72,2.19,111
"485","female",40,50,3.38,1.91,90
"486","male",55,44,2.42,2.13,99
"487","male",48,39,3.04,1.99,87
"488","female",51,59,3.55,2.76,110
"489","female",43,56,2.05,1.08,99
"490","male",49,66,3.17,2.38,115
"491","female",63,47,3.49,1.77,110
"492","female",38,40,2.99,1.78,78
"493","male",36,46,2.64,2.16,82
"494","female",68,66,2.52,3.2,134
"495","female",46,60,4.08,2.85,106
"496","male",62,61,3.8,3.19,123
"497","female",57,50,2.81,2.2,107
"498","male",51,58,3.07,1.8,109
"499","male",58,49,3.04,1.54,107
"500","female",46,49,2.46,2.92,95
"501","female",45,59,3.37,3.5,104
"502","male",58,56,4,2.71,114
"503","female",38,47,3.55,1.37,85
"504","female",44,54,2.78,1.7,98
"505","female",66,65,3.47,3.25,131
"506","male",55,65,2.72,1.82,120
"507","female",55,62,3.23,3.29,117
"508","female",63,60,4.11,3.81,123
"509","female",48,62,3.26,1.56,110
"510","male",58,52,2.49,2.94,110
"511","female",57,45,3.29,2.7,102
"512","female",44,44,3.6,2.77,88
"513","male",48,50,2.63,1.66,98
"514","female",49,60,2.81,2.01,109
"515","female",56,54,4.04,2.14,110
"516","male",53,64,3.26,2.97,117
"517","male",49,54,3.14,2.93,103
"518","male",46,59,2.73,2.28,105
"519","female",59,57,3.79,3.05,116
"520","female",51,51,3.34,2.79,102
"521","male",50,42,3.05,1.43,92
"522","male",56,45,3.14,2.92,101
"523","female",49,59,3.91,2.74,108
"524","female",52,52,3.01,3.27,104
"525","male",37,53,3.02,1.35,90
"526","male",46,53,3.51,1.28,99
"527","male",51,48,2.2,1.41,99
"528","male",41,51,3.94,2.16,92
"529","female",48,49,3.33,1.99,97
"530","female",50,65,3.13,2.86,115
"531","male",48,60,2.12,2.26,108
"532","male",54,59,3.43,2.58,113
"533","female",54,66,3.66,3.56,120
"534","female",40,60,3.72,1.84,100
"535","female",38,44,2.05,1.84,82
"536","female",49,51,2.53,1.74,100
"537","female",42,45,2.91,1.55,87
"538","female",45,55,2.91,2.34,100
"539","male",58,55,3.62,2.57,113
"540","female",57,54,3.03,2.5,111
"541","male",44,70,3.14,2.18,114
"542","male",56,54,2.97,3.18,110
"543","female",38,57,3.16,1.73,95
"544","female",61,68,3.53,2.64,129
"545","male",40,55,2.77,1.87,95
"546","female",46,58,2.23,1.77,104
"547","male",60,57,3.21,3.84,117
"548","male",48,51,2.31,2.55,99
"549","female",32,31,2.26,1.87,63
"550","female",45,65,4.02,2,110
"551","male",43,49,2.54,2.36,92
"552","female",53,54,3.56,3.44,107
"553","female",42,39,3.12,1.94,81
"554","female",47,60,3.04,1.77,107
"555","female",47,42,2.51,0.76,89
"556","female",47,65,4.09,3.55,112
"557","male",58,49,3,2.57,107
"558","female",46,56,4.08,2.44,102
"559","male",51,47,3.92,2.41,98
"560","female",56,59,3.31,2.8,115
"561","female",48,61,4.01,2.74,109
"562","male",54,49,2.67,1.82,103
"563","male",55,62,3.45,3.44,117
"564","male",45,43,2.44,1.32,88
"565","female",55,59,3.84,3.37,114
"566","female",47,46,3.28,3.05,93
"567","female",50,54,3.02,1.47,104
"568","male",49,47,2.47,2.61,96
"569","male",47,58,3.2,3.04,105
"570","male",49,53,2.76,2.92,102
"571","female",50,52,2.49,1.37,102
"572","male",60,57,4.12,3.09,117
"573","male",48,60,3.68,3.28,108
"574","male",45,50,3.05,2.72,95
"575","male",41,56,3.2,3.9,97
"576","female",46,46,2.08,2.12,92
"577","female",43,54,3,1.8,97
"578","male",57,47,3.32,2.15,104
"579","female",61,61,3.72,3.6,122
"580","male",45,54,2.78,3.31,99
"581","female",54,47,3.82,2.59,101
"582","male",53,58,3.26,2.01,111
"583","female",51,55,3.66,4.03,106
"584","male",48,52,2.35,2.77,100
"585","male",54,56,3.82,3.4,110
"586","female",50,59,3.72,1.9,109
"587","male",39,55,3.47,2.19,94
"588","male",44,65,3.51,3.36,109
"589","female",48,61,2.1,2.37,109
"590","male",63,62,3.63,3.11,125
"591","male",58,65,3.62,4.18,123
"592","male",41,58,2.93,2.19,99
"593","male",51,38,2.77,2.35,89
"594","female",50,48,3.84,2.73,98
"595","female",54,44,2.64,2.5,98
"596","female",61,58,3.28,3.64,119
"597","male",46,57,3.41,2.63,103
"598","male",66,74,3.45,3.23,140
"599","female",30,45,3.3,2.43,75
"600","female",43,43,2.12,1.32,86
"601","female",48,39,2.74,1.98,87
"602","female",46,62,2.75,2.68,108
"603","female",42,59,3.37,2.64,101
"604","male",60,58,4.03,3.4,118
"605","female",32,50,3.23,2.64,82
"606","male",57,47,3,3.15,104
"607","female",65,65,2.82,2.17,130
"608","female",56,72,4.11,1.93,128
"609","female",57,62,2.43,2.8,119
"610","male",59,62,3.58,2.47,121
"611","female",45,71,3.33,2.07,116
"612","female",58,66,3.1,3.47,124
"613","female",40,47,2.83,0.57,87
"614","male",44,56,3.73,2.2,100
"615","female",42,44,3.05,1.74,86
"616","female",64,60,3.78,3.91,124
"617","male",58,50,3.03,3.26,108
"618","female",44,73,3.08,2.88,117
"619","female",63,63,3.34,3.14,126
"620","male",37,49,2.62,1.27,86
"621","male",61,56,3.98,3.38,117
"622","female",61,63,2.33,1.11,124
"623","female",53,45,2.66,1.67,98
"624","male",46,65,2.67,2.02,111
"625","male",54,57,3.46,3.42,111
"626","female",44,47,2.88,1.78,91
"627","male",53,51,2.85,2.46,104
"628","female",63,67,3.88,1.73,130
"629","male",61,57,3.84,3.46,118
"630","female",38,46,2.3,0.6,84
"631","female",42,54,3.81,3.74,96
"632","male",57,65,3.86,3.96,122
"633","male",39,50,3.92,1.65,89
"634","male",48,59,2.53,2.28,107
"635","male",62,57,3.93,3.2,119
"636","male",67,58,4.04,3.71,125
"637","male",59,56,2.57,2.57,115
"638","male",43,54,2.26,1.68,97
"639","female",44,45,3.38,2.1,89
"640","male",54,59,3.24,2.79,113
"641","female",44,60,4.01,3.07,104
"642","female",45,51,2.85,2.94,96
"643","male",52,62,3.18,1.25,114
"644","female",45,61,2.37,1.89,106
"645","female",57,59,2.66,2.96,116
"646","female",41,48,3.71,1.08,89
"647","male",46,54,3.9,3.66,100
"648","male",43,56,3.82,2.83,99
"649","male",48,53,2.56,1.8,101
"650","female",44,45,2.86,1.92,89
"651","female",54,57,4.12,4.19,111
"652","male",42,59,3.01,2.74,101
"653","female",55,51,2.34,2.02,106
"654","male",67,59,3.67,3.22,126
"655","male",45,46,3.32,2.32,91
"656","male",49,53,3.97,3.36,102
"657","male",40,44,3.02,2.04,84
"658","male",46,50,2.87,2.26,96
"659","female",50,51,2.8,1.47,101
"660","male",41,46,3.54,3.19,87
"661","female",51,49,2.75,1.33,100
"662","female",40,46,2.98,1.06,86
"663","male",43,39,2.14,1.29,82
"664","female",42,49,3.58,3.13,91
"665","male",52,73,4.07,4.01,125
"666","female",46,54,3.13,2.86,100
"667","female",53,55,2.73,2.17,108
"668","male",58,54,2.73,2.63,112
"669","female",48,52,3.09,1.65,100
"670","female",42,62,2.7,0.8,104
"671","male",51,55,3.89,2.52,106
"672","female",49,65,3.13,2.29,114
"673","female",42,57,2.9,2.43,99
"674","female",44,61,3.48,3.24,105
"675","male",47,62,2.54,2.65,109
"676","male",71,67,3.61,3.41,138
"677","male",56,68,3.59,2.79,124
"678","male",54,62,4.03,3.14,116
"679","female",53,58,3.67,3.22,111
"680","female",62,60,3.13,2.55,122
"681","male",45,56,3.06,1.98,101
"682","male",43,55,2.74,1.32,98
"683","female",51,60,3.9,2.63,111
"684","female",56,69,3.68,2.27,125
"685","male",55,55,3.49,3.8,110
"686","female",44,68,3.3,2.48,112
"687","female",45,55,3.7,2.68,100
"688","female",33,48,4.03,2.25,81
"689","male",38,60,3.78,2.99,98
"690","female",63,67,4.08,3.45,130
"691","male",59,52,2.95,2.38,111
"692","female",42,33,3.11,2.35,75
"693","male",35,45,2.8,2.39,80
"694","male",57,68,3.16,2.37,125
"695","male",55,65,4.01,3.39,120
"696","male",37,39,2.17,1.77,76
"697","female",37,65,3.29,2.94,102
"698","female",49,53,3.3,2.71,102
"699","female",45,54,3.22,1.91,99
"700","male",55,68,3.69,3.7,123
"701","female",45,66,3.92,2.5,111
"702","female",56,63,3.99,3.45,119
"703","male",35,55,4.06,3.82,90
"704","male",55,61,2.74,1.7,116
"705","female",61,72,3.53,2.58,133
"706","female",41,47,3.12,2.63,88
"707","female",48,50,3.06,2.46,98
"708","male",58,67,3.37,2.5,125
"709","male",47,61,2.94,1.9,108
"710","male",46,58,2.47,1.69,104
"711","female",36,47,2.91,2.29,83
"712","female",52,71,2.35,2.21,123
"713","female",42,54,3.73,2.67,96
"714","male",50,60,2.68,2.79,110
"715","male",41,46,2.9,1,87
"716","female",42,44,2.95,1.71,86
"717","male",49,41,3.24,1.7,90
"718","male",48,51,3.53,3.08,99
"719","male",59,52,2.41,2.05,111
"720","female",45,54,3.43,1.66,99
"721","male",62,56,3.56,3.14,118
"722","female",64,63,4.04,3.16,127
"723","male",38,55,2.94,2.31,93
"724","female",57,57,4.11,3.18,114
"725","male",44,61,2.97,2.64,105
"726","female",43,41,3.64,3.01,84
"727","male",39,47,3.66,2.15,86
"728","female",43,50,3.47,2.65,93
"729","female",47,58,3.91,3.08,105
"730","female",40,52,2.86,1.65,92
"731","male",52,41,2.31,0.53,93
"732","male",42,38,3.34,2.28,80
"733","female",66,65,3.94,3.45,131
"734","male",45,48,2.7,0.81,93
"735","male",48,48,3.4,2.98,96
"736","female",47,49,2.56,2.75,96
"737","female",54,47,2.4,2.29,101
"738","male",53,50,3.52,2.41,103
"739","female",48,55,3.52,2.35,103
"740","female",43,50,2.78,1.58,93
"741","male",42,52,2.74,2.27,94
"742","male",39,48,2.92,2.02,87
"743","male",35,39,2.41,0.7,74
"744","male",58,51,2.72,1.04,109
"745","female",41,67,2.84,2.13,108
"746","male",57,67,4.06,3.56,124
"747","female",30,33,2.23,1.39,63
"748","female",45,62,3.6,2.81,107
"749","female",45,37,2.07,1.02,82
"750","female",45,55,2.65,2.57,100
"751","female",35,46,3.14,1.14,81
"752","female",48,63,2.78,2.6,111
"753","male",48,47,2.76,2.55,95
"754","male",51,40,3.42,2.73,91
"755","female",51,58,3.19,2.45,109
"756","male",55,61,2.7,2.3,116
"757","male",40,54,2.49,1.91,94
"758","male",58,50,3.66,2.03,108
"759","male",61,62,3.87,4.14,123
"760","female",44,67,3.67,1.73,111
"761","male",41,49,3.83,1.66,90
"762","male",38,46,3.13,2.93,84
"763","male",42,55,3.43,1.47,97
"764","female",58,66,3.99,3.36,124
"765","female",52,65,2.81,0.95,117
"766","female",41,41,3.58,1.63,82
"767","female",43,45,2.66,1.52,88
"768","female",56,56,2.86,2.69,112
"769","female",56,59,2.96,2.53,115
"770","male",47,37,2.59,1.47,84
"771","female",55,64,4.05,3.58,119
"772","female",42,66,3.59,2.57,108
"773","male",53,59,2.47,1.62,112
"774","male",64,63,3.88,3.18,127
"775","male",38,47,3.58,3.02,85
"776","female",49,41,2.23,0.62,90
"777","male",55,52,2.89,2.56,107
"778","male",53,54,3.43,2.59,107
"779","male",46,51,3.08,2.09,97
"780","female",47,59,3.23,2.91,106
"781","male",44,51,2.88,1.74,95
"782","female",44,44,3.18,1.76,88
"783","male",55,51,3.43,2.04,106
"784","male",51,60,3.83,3.59,111
"785","female",57,65,4.12,2.32,122
"786","male",68,51,3.17,2.57,119
"787","female",48,49,2.61,1.96,97
"788","male",63,72,4.07,2.79,135
"789","female",61,58,4.09,3.84,119
"790","female",53,59,3.33,3.1,112
"791","male",54,50,3.33,1.45,104
"792","female",51,56,4.03,3.02,107
"793","female",47,56,2.09,2.13,103
"794","male",44,48,3.53,2.37,92
"795","male",53,54,3.51,2.23,107
"796","male",43,52,3.06,1.57,95
"797","male",44,55,3.16,2.01,99
"798","female",50,58,3.46,2.87,108
"799","male",50,54,3.17,1.97,104
"800","male",40,48,3.16,2.46,88
"801","male",42,46,3.2,2.93,88
"802","female",45,61,3.68,3.1,106
"803","male",37,56,2.68,2.16,93
"804","female",55,43,2.45,1.25,98
"805","female",55,57,2.65,1.83,112
"806","female",47,57,2.89,2.53,104
"807","male",49,58,3.15,2.43,107
"808","male",38,36,2.23,1.38,74
"809","female",46,54,3.07,2.32,100
"810","male",45,50,3.62,3.07,95
"811","male",65,71,4.09,3.74,136
"812","female",55,64,4.11,3.13,119
"813","male",53,54,3.08,2.55,107
"814","female",47,51,3.34,2.32,98
"815","male",49,45,2.78,3.12,94
"816","female",39,53,3.1,1.77,92
"817","male",48,55,3.39,2.76,103
"818","female",46,51,2.89,0.67,97
"819","female",51,65,3.81,2.66,116
"820","female",63,59,3.81,2.86,122
"821","male",50,59,3.79,3.85,109
"822","female",44,61,2.56,1.41,105
"823","female",47,58,3.21,2.51,105
"824","female",37,51,3.05,2.3,88
"825","male",57,53,3.36,2.45,110
"826","female",67,50,3.03,2.89,117
"827","female",42,56,3.4,3.53,98
"828","female",66,72,3.47,3.28,138
"829","female",56,61,3.61,3.45,117
"830","male",75,55,3.67,2.93,130
"831","male",34,59,2.76,1.71,93
"832","female",49,60,3.55,3,109
"833","female",34,48,3.6,2.23,82
"834","male",35,42,2.77,1.93,77
"835","male",47,58,2.77,3.28,105
"836","female",48,59,3.17,1.65,107
"837","female",60,51,4.08,4.11,111
"838","male",61,63,3.52,2.21,124
"839","male",64,49,2.56,2.36,113
"840","male",47,44,3.64,2.34,91
"841","female",49,66,3.36,2.92,115
"842","male",30,36,2.61,0.63,66
"843","female",52,56,3.46,2.83,108
"844","male",48,61,2.58,2.63,109
"845","female",50,52,2.7,1.78,102
"846","male",49,48,3.46,2.78,97
"847","female",52,56,3.22,3.47,108
"848","female",37,46,2.44,2.88,83
"849","female",36,50,2.05,2.28,86
"850","male",39,54,3.81,2.73,93
"851","female",38,39,3.89,2.58,77
"852","female",58,57,2.61,2.43,115
"853","female",50,57,2.14,1.33,107
"854","female",56,58,3.5,3.71,114
"855","female",46,32,2.06,1.06,78
"856","male",61,50,3.36,3.05,111
"857","female",60,71,3.11,3.39,131
"858","male",55,57,3.16,2.64,112
"859","female",45,58,2.93,2.54,103
"860","male",36,34,2.76,2.28,70
"861","female",47,53,2.5,1.58,100
"862","male",48,51,3.39,2.34,99
"863","female",49,62,4.11,3.48,111
"864","female",60,53,4.02,2.46,113
"865","female",48,56,2.97,3.07,104
"866","female",37,43,2.25,0.04,80
"867","female",56,62,4.12,3.62,118
"868","male",41,45,2.92,1.84,86
"869","male",64,57,2.62,2.93,121
"870","male",39,54,2.2,0.99,93
"871","female",70,56,3.03,3.32,126
"872","male",51,63,2.8,1.73,114
"873","female",56,62,3.21,3.61,118
"874","female",33,56,2.92,2.14,89
"875","male",39,51,2.29,1.56,90
"876","female",43,43,2.06,1.36,86
"877","female",56,56,2.55,0.76,112
"878","male",33,33,2.86,1.99,66
"879","male",40,50,2.51,1.69,90
"880","male",45,65,3.42,1.95,110
"881","female",41,56,3.06,2.14,97
"882","female",48,56,4.08,3.22,104
"883","male",55,56,3,2.52,111
"884","female",43,39,3.31,1.38,82
"885","male",46,55,2.74,2.1,101
"886","female",49,55,2.92,1.69,104
"887","female",59,67,3.1,3.05,126
"888","male",49,51,4.12,2.61,100
"889","male",64,57,3.19,2.77,121
"890","male",41,52,3.35,2.35,93
"891","male",48,58,3.77,3.67,106
"892","female",52,55,3.02,1.16,107
"893","female",55,70,3.66,2.52,125
"894","male",34,46,2.31,1.64,80
"895","male",49,54,2.6,2.23,103
"896","female",51,54,3.66,3.29,105
"897","male",51,48,2.99,2.59,99
"898","male",50,58,3.86,2.08,108
"899","male",51,45,2.79,2.78,96
"900","female",46,60,2.87,2.14,106
"901","male",56,71,3.83,1.85,127
"902","male",44,66,3.84,2.88,110
"903","female",50,48,2.74,2.76,98
"904","female",45,49,2.07,1.27,94
"905","male",41,47,2.97,1.68,88
"906","male",41,51,3.92,3.79,92
"907","male",53,44,2.69,1.81,97
"908","female",50,46,3.32,3.01,96
"909","male",39,54,3.15,2.86,93
"910","male",46,64,2.66,1.94,110
"911","female",47,42,2.07,0.07,89
"912","male",54,56,3.79,3.72,110
"913","male",48,61,2.5,2.63,109
"914","female",62,63,4.08,3.25,125
"915","male",38,60,3.06,1.86,98
"916","female",43,56,2.21,1.77,99
"917","male",43,44,2.67,1.25,87
"918","male",59,63,4.06,3.23,122
"919","male",40,56,3.37,2.1,96
"920","female",45,43,2.11,1.79,88
"921","female",49,42,4.1,3.02,91
"922","male",50,64,3.14,2.13,114
"923","female",42,50,3.42,3.28,92
"924","female",50,49,2.98,2.34,99
"925","male",47,46,2.73,2.43,93
"926","female",42,54,2.08,1.86,96
"927","male",45,60,3,2.75,105
"928","male",49,53,2.9,2.59,102
"929","male",30,50,2.08,0.78,80
"930","female",40,52,3.62,1.98,92
"931","female",49,50,2.9,2.8,99
"932","female",54,73,3.48,3,127
"933","female",46,62,2.97,2.34,108
"934","male",44,52,3.67,2.99,96
"935","female",51,58,3.43,1.81,109
"936","male",40,61,3.88,3.14,101
"937","female",52,55,3.34,3.5,107
"938","female",54,67,3.46,2.27,121
"939","female",43,47,4.11,2.62,90
"940","female",33,41,2.55,2.85,74
"941","female",50,49,2.48,1.29,99
"942","female",47,55,3.31,3.32,102
"943","male",63,70,3.52,3.31,133
"944","female",59,53,3.11,3.66,112
"945","male",55,57,3.32,2.66,112
"946","female",54,54,2.98,2.13,108
"947","male",51,55,3.21,3.64,106
"948","female",37,39,2.06,2.21,76
"949","male",54,49,3.31,2.99,103
"950","male",67,71,2.96,2.45,138
"951","male",50,55,3.02,2.83,105
"952","female",66,54,3.64,2.86,120
"953","female",44,55,3.13,2.64,99
"954","female",53,46,3.39,2.16,99
"955","male",49,60,2.77,1.7,109
"956","male",64,57,3.75,3.82,121
"957","male",45,56,3.37,2.02,101
"958","male",44,58,2.76,2.45,102
"959","female",60,58,3.79,3.63,118
"960","female",53,52,2.07,1.93,105
"961","female",39,43,2.6,3.24,82
"962","female",44,46,2.06,0.31,90
"963","female",47,51,3.12,2.67,98
"964","male",61,51,2.31,2.79,112
"965","female",36,53,3.74,2.98,89
"966","female",48,62,3.16,1.84,110
"967","male",59,73,4.04,2.88,132
"968","male",57,57,3.87,4.12,114
"969","male",43,55,2.74,3.59,98
"970","male",53,59,3.73,2.4,112
"971","male",60,51,2.73,2.3,111
"972","male",58,66,4.04,3.32,124
"973","male",66,54,3.82,3.55,120
"974","female",56,72,3.48,2.47,128
"975","male",44,38,2.99,2.34,82
"976","female",58,65,2.64,3.79,123
"977","female",55,62,3.84,2.3,117
"978","male",43,51,3.39,2.91,94
"979","female",52,49,2.96,3.56,101
"980","female",59,49,3,2.08,108
"981","male",31,48,2.39,0.57,79
"982","female",76,52,3.15,3.02,128
"983","female",58,43,3.02,3.46,101
"984","male",44,54,3.96,3.12,98
"985","female",44,49,2.5,0.86,93
"986","female",48,60,3.75,3.09,108
"987","male",51,55,3.77,1.75,106
"988","male",55,52,2.72,0.99,107
"989","male",54,60,3.49,3.52,114
"990","male",45,49,2.09,1.19,94
"991","male",49,38,3.71,1.72,87
"992","female",49,73,3.43,2.91,122
"993","male",47,54,3.61,1.24,101
"994","male",48,52,3.64,2.69,100
"995","female",39,51,3.39,2.73,90
"996","male",55,50,3.58,2.08,105
"997","female",40,52,2.34,2.2,92
"998","female",55,66,3.48,3.54,121
"999","male",60,54,3.45,2.5,114
"1000","female",51,51,3.1,3.22,102
